0000000000000000000000000
1111111111000000000000000
0000000000000000111111111
0000000000000010000000000
1111110000000000000000000
0000000011111111111000000
0000001100000000000011000
0002000000000000000000030
